11111111111111
101C0000000101
10111110P10101
1C0000C001C001
11110011110111
1C000E000C0001
11111111111111
