11111111111111
101C00000P0101
10111110010101
1C0000C001C001
11110011110111
1C00E0000000C1
11111111111111